1111111111
1111111111
1111111111
1111111111
1100000011
0001111111
1111111111
1111111111
1111111111